44x6
############################################
#                                          #
#      PPPPP                        AAAAA  #
#      PPPPP                        AAAAA  #
#      PPPPP                        AAAAA  #
############################################